ちゅごくじん	中国人		中国人
にほんじん	日本人		日本人
かんこくじん	n国人		韩国人
アメリカじん	アメリカ人	美国人
フランス人	フランス人	法国人
がくせい		学生		学生
せんせい		先生		先生
りゅがくせい	留学生		留学生
きょうじゅ	教授		教授
しゃいん		社T		职员
かいしゃいん	会社T		公司职员
てんいん		店T		店员
けんしゅうせい	研修生		进修生
きぎょう		企I		公司
だいがく		大学		大学
ちち		父		父亲
かちょう		nL		科长
しゃちょう	社L		总经理 社长
でむかえ		出迎え		迎接
あのひと		あの人		那个人
わたし		私		我
あなた				你
どうも				实在

こんにちは			你好
すみません			对不起 请问
どうぞ				请				
はじめまして	初めまして	初次见面
こちらこそ			彼此彼此
そうです				是
ちがいます			不是
わかりません	分かりません	不知道
どうもすみません			实在对不起