うた		歌		歌，歌曲
カラオケ			卡拉ok
ロック				摇滚乐
ポップス			流行音乐
クラシック			西方古典音乐
ピアノ				钢琴
え		絵		画儿
えいご		英語		英语
スペインご	スペイン語	西班牙语
スポーツ			体育，运动
すいえい	水泳		游泳
ゴルフ				高尔夫球
うんてん	運転		开车
のみもの	飲み物		饮料
おさけ		お酒		酒，酒类
にく		肉		肉
やさい		野菜		蔬菜
水果
向日葵
蔷薇，玫瑰
计算机，电脑
窗，窗户
结婚典礼
别墅
木片儿拼花工艺品
花纹，纹案
外国
会议
あし		脚		腿
ぼく				我（男性自称）
わかります	分かります	懂，明白【动1】
まよいます	迷います	犹豫，难以决定【动1】
̪しめます	閉めます	关闭，关门【动2】
つかれます	つかれます	疲倦，疲惫【动2】
さんぽします	散歩します	散步【动3】
こわい		怖い		害怕，恐怖【形1】
あかい		赤い		红【形1】
いたい		痛い		疼，疼痛【形1】
じょうず	上手		擅长，高明，水平高【形2】
へた		下手		不高明，水平低【形2】
にがて		苦手		不擅长，不善于【形2】
ときどき	時々		有时，时不时
よく				经常，常常
たまに				偶尔，很少
また				还，再，又
どうして			为什么
でから				所以，因此 ですから
嗯 这个

けっこうです	結構です	不用，不要
きにいります	気に入ります	中意，喜欢
など				等等







