おと		音		声音，响声
こえ		声		声音
くうき		空気		空气
むすこ		息子		儿子
いしゃ		医者		医生
おじょうさん	お嬢さん	令爱
しゃかいじん	社会人		社会的一员，成人
りょこうガイド	旅行ガイド	旅行导游
がくしゃ	学者		学者
パイロット			飞行员
デザイナ			设计者，设计家
タイムサービス			时段廉价销售
しんしゅんセイル	新春セイル		新年大甩卖
さんわりびき	三割引き	七折
ていか		定価		定价
はんがく	半額		半价
ねだん		値段		价格
シャツ				衬衫
スカート			裙子
いろ		色		颜色
あか		赤		红色
あお		青		蓝色
おしょうがつ	お正月		过年，新年
じかん		時間		时间
しょうらい	将来		将来
じゅんび	準備		准备
びょうき	病気		疾病
なります			变，当，变为，成为【动1】	なる
あきます	開きます	开【动1】	開く
にあいます	似合います	适合，相称【动1】	似合う
うるさい			闹，使人心烦【形2】
シンプル			单纯，简洁【形2】
まもなく	間もなく	马上，一会儿，不久
もうすぐ			马上
さらに　もうと			更加，更
さあ				啊，喂

できるだけ			尽量，尽可能
まとめて			一下子，一起，汇总，聚集
いまから	今から		从现在起