しなもの		品物		物品，商品
おさら			お皿		盘子
ごみ					垃圾		ゴミ
しょしんしゃ		初心者		初学者
じょうきゅうしゃ	上級者		熟练者
こうきゅう		高級		高级
じょうきゅうクラス	上級クラス	高级班		初級クラス
えいかいわ		英会話		英语会话	会話クラス
コース					路线，滑道
スキー					滑雪
レポート				报告
パスポート				护照
のど			喉		喉咙		喉が渇きました
さわります		触ります	触，碰【动1】		触る	に	ここに触る
ぬぎます		脱ぎます	脱【动1】		脱ぐ
ころびます		転びます	摔，摔倒【动1】		転ぶ
かわきます		渇きます	渴【动1】		渇く
なおります		治ります	痊愈，医好【动1】	治る
すべります		滑ります	滑，滑行【动1】		滑る		滑梯 すべりだい滑り台	（くち）口が滑る
よびます		呼びます	呼喊【动1】		呼ぶ
かえします		返します	归还【动1】		返す
てつだいます		手伝います	帮忙【动1】		手伝う
はこびます		運びます	搬运【动1】		運ぶ
なくします		失くします	丢，丢失【动1】		失くす
おとします		落とします	掉，使落下【动1】	落とす
おきます		置きます	放置【动1】		置く		何を	ここに
はらいます		払います	支付【动1】		払う
たちます		立ちます	站，立【动1】		立つ		生气 腹が立つ
わすれます		忘れます	忘记【动2】		忘れる
あわてます		慌てます	惊慌，慌张，着急【动2】	慌てる
すてます		捨てます	扔，扔掉【动2】		捨てる
ざんぎょうします	残業します	加班【动3】		残業する
しんぱいします		心配します	担心【动3】		心配する
ほんとう		本当		真的，真正				うそ
はやく			早く		早点儿
やっと					好不容易，终于
だいぶ					很，相当地				跟变化词 なります	だいぶ上手になります
はじめて		初めて		第一次
さきに			先に		先
やまだ			山田		山田

たち					们


动词ない形	否定形

	原型	ます		ない

动1
	書く	書きます	書かない
	急ぐ	急ぎます	急がない
	話す	話します	話さない
	待つ	待ちます	持たない
	死ぬ	死にます	死なない
	呼ぶ	呼びます	呼ばない
	休む	休みます	休まない
	撮る	撮ります	撮らない
		あります	ない
	会う	会います	会わない

动2
	食べる	食べます	食べない
	見る	見ます		見ない

动3
	来る	来ます		こない	来ない
	する	します		しない


动1 原型的结尾音变为あ段 加ない		あります→ない	あ→わ
洗う→洗わない
吸う→吸わない


动2 去る加ない
动3 来る→来ない	する→しない



礼貌形 			简体形
对陌生人 下对上		对亲朋 上对下
食べます		食べる
食べません		食べない
食べました		
食べませんでした


1.部屋のかぎを	忘れないで	ください。
		忘れます→忘れない

动词ない形+でください
请别。。。。


2.李さんは今日早く	帰ら	なければなりません。
			帰ります→帰らない

なければなりません
ないといけません
表必须

假定形	い→なければ
帰ります→帰らない→帰らなければ

毎日勉強しなければなりません。
今日は友達に会わなければなりません。

毎朝朝ご飯を食べなければなりません。

3.明日は	残業しなくてもいいですよ。
		残業します→残業しない→残業しなく

なくてもいいです
不。。。也行

明後日学校へ来なくてもいいです。
明日の朝早く起きなくてもいいです。

4.あの人	が	吉田課長ですよ。
誰が吉田課長ですが

あの人	は	吉田課長ですよ。
あの人は誰ですが

が前は后





















