しゅみ		趣味		爱好
とくぎ		特技		特长，拿手的技术
きょうみ		興味		兴趣		对XXX感兴趣	に興味があります	興味を持っています
ゆめ		夢		梦，梦想		夢を見ます	夢があります	夢を持っています
ギター				吉他		ギターを弾きます
こきゅう		胡弓		胡琴		にこ二胡
しょどう		書道		书法		さどう茶道
						かどう華道
						じゅうどう柔道
						けんどう剣道
						からてどう空手道
つり		釣り		钓鱼		釣りをします	所有运动都是します
ドライブ				兜风，开汽车远游
あみもの		編み物		编织，编织品	編みます
てづくり		手作り		手工做，自己做，手制
ちゅうかがい	中華街		中华街
ちゅうかりょうり	中華料理		中国菜
ギョーザ		餃子		饺子
かわ		皮		皮
しゅんせつ	春節		春节
ししまい		獅子舞		狮子舞
りょう		寮		宿舍
せんたくき	洗濯機		洗衣机
シャワー				淋浴		シャワーを浴びます
おなか		お腹		肚子
じゅぎょう	授業		授课，上课
しりょう		資料		资料
フランスご			法语
しょうせつ	小説		小说
かいがん		海岸		海岸
ふゆやすみ	冬休み		寒假
キャンプ				野营
みんな		皆		大家
じぶん		自分		自己
ぜんいん		全員		全员
ひきます		弾きます		弹【动1】		弾く
すきます		空きます		饿，空【动1】	空く
のぼります	上ります		登，上【动1】	上る
あつめます	集めます		收集【动2】	集める	切手を集めます
あびます		浴びます		淋，浇【动2】	浴びる
ごちそうします	御馳走します	请客，摆盛宴【动3】	ごちそうする
きこくします	帰国します	回国【动3】	帰国する
とくに		特に		特别

おなかがすきます	お腹が空きます	肚子饿	のどがかわきますのどが渇きます

基本型

ます	基本型
动1
書きます	書く
急ぎます	急ぐ
話します	話す
持ちます	持つ
死にます	死ぬ
呼びます	呼ぶ
休みます	休む
取ります	取る
会います	会う
动2
食べます	食べる
見ます	見る
动3
来ます	来る
します	する


い段 但属于动2的词
います
起きます
過ぎます
降ります
見ます
できます
借ります
浴びます
				事
1.スムスさん	はピアノを弾く	こと	が	できます。
				形式体言
				把动词词组名词化
动词基本型+ことができます	能做某事

料理を作ることができます

体言	名词 数词 代词

2.私の趣味	は切手を集めること	です。

名词は+动词基本型+ことです

私の趣味は泳ぐことです。
私の趣味は水泳です。
私の夢は先生になることです。

3.こちらへ来る	前に	、電話をかけてください。
		时间从句
动词基本型+前に
在。。。之前

食べる前に、手を洗います。

4.冬休み、どこ	か	へ行きたいです。
疑问词+か
不确定的表现形式
どこが表示某地
あそこにだれかがいますが

何かがありますが
いつか
