ことば		言葉		语言		寝言ねごと
メールアドレス			邮件地址
れんきゅう	連休		连休
ゴールデンウィーク			黄金周		4月29日	5月5日
						緑の日	子供の日
おわり		終わり		结束
きゅうけいじかん	休憩時間		休息时间
きょうげき	京劇		京剧		劇場げきじょう
きっぷ		切符		票（券）		定期券ていきけん	チケット
からだ		体		身体		体に気を付けて
じしん		地震		地震
どろぼう		泥棒		小偷，盗贼	扒手 スリ		万引き
ちゅうしゃじょう	駐車場		停车场
わたします	渡します		交给【动1】	渡す
おくれます	遅れます		迟到【动2】	遅れる
かんがえます	考えます		考虑【动2】	考える
しらべます	調べます		调查【动2】	調べる	问问 打听		調査ちょうさ
きます		着ます		穿【动2】		着る
よやくします	予約します	预约，预定【动3】	予約する	予約席よやくせき
かんしゃします	感謝します	感谢【动3】	感謝する
うんどうします	運動します	运动【动3】	運動する
せんたくします	洗濯します	洗涤，洗【动3】	洗濯する	服を洗います
ほうこくします	報告します	报告【动3】	報告する	下对上
あぶない		危ない		危险【形1】		危険きけん	危機きき
それとも				还是，或者	比が更多用于句子之间的连接
とうきょうたわー	東京タワー	东京塔

そんなに				那么		そんな+名词 そんなに+用言
すぎ		過ぎ		多		吃多了 食べ過ぎ	喝多了 飲み過ぎ	睡过头了 寝過ぎ


动词た形

和て形完全一直
て→た
で→だ


	礼貌形		简体形
肯	食べます		食べる
否	食べません	食べない
过	食べました	食べた
否过	食べませんでした	食べなかった

1.私は	すき焼きを食べた	こと	があります。
			形式体言
			动词词组名词化
动词た形+ことがあります
曾经做过。。。

私は上海へ行ったあります。
私は映画を見たがあります。

中国へ来る前に、中国語を勉強したことがありますが。

このお茶を飲んだことがありますが。
京劇を見たことがありますが。

2.李さんは会社が終わった	後で、飲みに行きます。
			时间从句
动词基本型+前に
动词た形+後で


3.もっと野菜を食べた	ほうがいいですよ。

动词た形+ほうがいいです
做。。。比较好

动词ない形+ほうがいいです
不做。。。比较好

日本のドラマをたくさん見たほうがいいです。
よく日本へ行ったほうがいいです。
日本の友達をたくさん作ったほうがいいです。

夜七時の後で何も食べないほうがいいです。

4.窓を閉めましょうか。

ましょうか	有礼貌的疑问 女性/下对上多用

一度もありません
何度も食べました
何度も食べたことがあります









