ハイキング				郊游，远足	遠足えんそく
おわかれ		お別れ		分别，分手	分かれます
はなし			話		说话		別れ話	わかればなし	笑い話わらいばなし	昔話むかしばなし
みおくり		見送り		送行，送别
あいだ			間		时间，期间	很长一段期间内 長い間	短い間		也可以表示空间
ほうりつ		法律		法律
おもいます		思います	想，思考【动1】	思う		用助词と
いいます		言います	说，讲【动1】	言う		用助词と
さがします		探します	找，寻找，寻求【动1】	探す	夢を探す	物を捜す
わらいます		笑います	笑【动1】	笑う		自动+他动	人が笑う	人を笑う 有嘲笑的意思
やめます		止める		戒，停止，放弃【动2】	やめる	タバコを止める	お酒をやめる
きめます		決めます	决定【动2】	決める		決める	決まる
ねぼうします		寝坊します	睡懒觉【动3】	寝坊する	朝寝坊
がいしゅつします	外出します	外出，出去【动3】	外出する
けんきゅうします	研究します	研究【动3】	研究する
おかしい				可笑，滑稽【形1】
いっぱい				满				頭がいっぱいです
すごい					惊人的，了不起【形1】
とうとう				终于，终究，到底
かならず		必ず		一定，必定		必ず+意志形	ぜひ+愿望	きっと+推测でしょう
ぜったいに		絶対に		绝对
ば			馬		马

おせわになりました		お世話になりました	承蒙照顾	お+になりました	尊他的构成方法
よろしくおつたえください	よりしくお伝えください	请代问好	お+ください	皆によりしくお伝えください
おげんきで			お元気で		请多保重	お大事に
おきをつけて			お気を付けて		小心点儿
さよなら						再见
どうやって						怎样，如何	やる→やって	问方式方法
やくにたちます			役に立ちます		有用
おなかがいっぱいです		お腹がいっぱいです	吃饱，饱
ちゅう							中		話し中	食事中	授業中
について						关于		日本の茶道について。。。


同根词
る前在え段上 为他动词	を
る前在あ段上 为自动词	が



1.李さんはもうすぐ	来る	と	思います。
			简体	代内容

第一人称	思います
		思っています	持续 一直以来都想
第二人称	思いますが
第三人称	思っています	第三人称不能用「思います」


省略と的地方：
1.疑问词	どう思いますが
2.代词		そう思います

行きたいです		愿望		希望干什么
行くと思います		思考，考虑
行きたいと思います


2.陳さんはパーティーに	行く	と	いいました。
			简体	代内容
说了要去晚会的事情

といいます
传闻

転勤だって	って一般用于口语
転勤と言います	と言います一般用于文章体



何と言いますが


3.すみません、頭が痛い	ん	です。
			口语用ん
			文章体用の

动词 形1	简体+んです
形2		な+んです
名		な+んです	如果用の 会和文章体的のです冲突 故改为な

んです	强调事实 强调理由原因

んですが	表达关心，好奇	行为反常
どうして食べないんですが。

4.東京タワーへ行きたい	んですが	、どうやって行きますが。
			表转折 + 请求，依赖

すみません、ちょっど分からないんですが、教えてくださいませんが。









