いま		今		现在
せんしゅう	先L		上个星期
らいしゅう	来L		下个星期
さらいしゅう	再来L		下下个星期
こんしゅう	今L		这个星期		げつ月	まいしゅう斑L	ことし今年
きのう		昨日		昨天		きょう今日
あした		明日		明天
あさって		明後日		后天
おととい		一昨日		前天		おととし一昨年
まいにち		叭		每天
まいあさ		俺		每天早晨		あさ朝	あさひ朝日
まいばん				每天晚上		
まいしゅう	斑L		每个星期
ごぜん		午前		上午		エ`エム
ごご		午後		下午		ピ`エム
にちようび	日曜日		星期日
げつようび	月曜日		星期一
かようび		火曜日		星期二
きんようび	金曜日      	星期五		花の金曜日
どようび		土曜日		星期六
けさ		今朝		今天早晨
こんばん		今		今天晚上
らいねん		来年		明年
きょねん		去年		去年
よる				晚上 夜里 夜晚
ばん		夜		晚上
あさ		朝		早晨
がっこう		学校		学校
しけん		Y		考试
しごと		仕事		工作
ちこく		W刻		迟到
やすみ		休み		休息
しゅっちょう	出		出差
けんしゅう	研修		进修	けんしゅうせい研修生
りょこう		旅行		旅行
てんらんかい	展E会		展览会	かい会
かんげいかい	Z迎会		欢迎会	かんそうかいZ送会
パ`ティ`			联欢会
おたく		お宅		府上 您家
いつ				什么时候
やすみます	休みます		休息【动1】	ます型 为动词
はたらきます	Pきます		工作【动1】
はじまります	始まります	开始【动1】
おわります	Kわります	结束【动1】
おきます		起きます		起床【动2】
ねます		寝ます		睡觉【动2】
べんきょうします	勉します	学习【动3】
いつも				经常
ペキンししゃ	北京支社		北京分社	ほんしゃ本社
こうべ		神		神户

おはよう				你早	おはようございます

じ		r
ぶん		分
はん		半
がつ		月
にち		日
ねん		年
ごろ				几点钟【左右】


ごふん		五分
じゅっぷん	十分
さんじゅっぷん	三十分	→	はん　半

r
いちじ		一r
よじ		四r
くじ		九r

1　6　8　10	ふん→ぷん	
1いっぷん
6ろっぷん
8はっぷん
10じゅっぷん

さん　なん　よん	ふん→ぷん
さんぷん
よんぷん
なんぷん

动词

	【礼貌型】		【口语更多】
			辞形	じしょけ
动1 五（う）段动词				①辞形结尾落在う段上
	Pきます		Pく
	休みます		休む
	始まります	始まる
	Kわります	Kわる
动2 一段动词				①る结尾②る前面一个音一定在い段上或え段上
	起きます		起きる
	寝ます		寝る
动3 特殊词	する结尾
	勉します	勉する


动1→ます
	う段尾变成い段尾 加ます	休む→休みます	む→み
动2→ます
	去る加ます		起きる→起きます
动3→ます
	する变します		勉する→勉します


	ます		ません		ました		ませんでした

	Pきます		Pきません	Pきました	Pきませんでした
	休みます		休みません	休みました	休みませんでした
	始まります	始まりません	始まりました	始まりませんでした
	Kわります	Kわりません	Kわりました	Kわりませんでした
	起きます		起きません	起きました	起きませんでした
	寝ます		寝ません		寝ました		休みませんでした
	勉します	勉しません	勉しました	勉しませんでした


1.今四rです。
不加は 因为今不是主语 如果加は则表示强调
2.森さんは七rに起きます。	ます表将来 表平时 总是
に 助词 动作产生的【具体时间】
【具体时间】	何r	何分	何曜日	何月	何日
【非具体时间】	先L	来L	今日	明日	来年	去年
3.森さんは先L休みました。	ました
4.私は昨日Pきませんでした。	ませんでした

昨日、何rから何rまでPきましたか。
から	まで	助词
从...开始	到...为止

九rから六rまでPきました。

いつ	不确定不具体
何r
何曜日

いつもは七rです。
は强调 对比性强调











