モノレール				单轨铁路，单轨列车
オイル					油，润滑油		油あぶら
ダンス					跳舞，舞		社交ダンスをします	踊り
じだい			時代		时代
やくしゃ		役者		演员			俳優はいゆう	女優じょゆう
むすめ			娘		女儿			お嬢さん	お娘さん
こいぬ			子犬		小狗
とかい			都会		都市，城市
げきじょう		劇場		剧场，剧院
ししゃかい		試写会		试映会，预映会
みみ			耳		耳朵			耳がいい	耳が悪い	耳が遠い 耳背	耳が速い 消息灵通	耳が痛い 说的话刺耳
								鍋の耳 锅边锅耳朵	パンの耳 面包边
おく			奥		里头，内部；深处
きげん			機嫌		情绪，心情		機嫌を取る 取悦于谁
せんじつ		先日		前几天，前些天		掃除機	洗濯機
コピーき		コピー機	复印机
けん					券，票			切符 电车票	乗車券じょうしゃけん	チケット
さいしゅうびん		最終便		最晚航班
にゅうじょうけん	入場券		入场券，门票
しょうたいけん		招待券		招待券，请帖
かいすうけん		回数券		回数券
むかいます		向います	往~去【动1】	向う
そろえます		揃えます	备齐，凑齐；使一致【动2】	揃える【他动词】	揃う【自动词】
もれます		漏れます	漏，泄露【动2】	漏れる		まとめる
かいつうします		開通します	开通【动3】	開通する
かいちくします		改築します	改建【动3】	改築する	建築けんちく
かんせいします		完成します	完成【动3】	完成する
にゅうしゃします	入社します	进公司，入社【动3】	入社する	入学にゅうがく	
しん			清		清，清代

おまたせしました	お待たせしました	让您久等了	待つ→待たせ 使役形





1.これから、友達と食事に	行く	ところです。
				基本型
动词基本型 + ところ
将要。。。正要。。。

2.森さんは会議の資料を	そろえている	ところです。

动词ている + ところ
正在做。。。


区别
ているところ	不能描述自然景色 只能描述人的行为
ている		可以强调自然景色	雨が降っています。



3.馬さんは今空港に	着いた	ところです。

动词た形 + ところ
刚刚做完。。。



ところです
应答对方的提问，邀请
说明自己的状况
多用于辩解，婉转的拒绝


4.このモノレールは去年開通したばかりです。

动词た形 + ばかり
刚刚做完。。。



区别
动词た形 + ところ	事实
动词た形 + ばかり	用于说话人自己觉得时间短




名 + ばかり	光。。只知道。。。



构词法
読みます→読み→読み終わります	読み始めます	読み続けます
見ます→見→見終わります	見始めます	見続けます
話します→話し→話し終わります	話し始めます	話し続けます

思い出します
泣き出します









